**000000000000000000000000000000000000000**
**000000000000000000000XXXXXXXXXXXXXXX000**
**000000000000000000000000000000000000000**
**00XXX0000000000000000000000000000000000**
**000000000000000000000000000000000000000**
**000000000000000000000000000000000000000**
**000000000XXX000000000000XXX000000000000**
**000000000000000000000000000000XX00000XX**
**000000000000000000000000000000000000000**
**000000000000000000000000000000000000000**
**000000000000000000000000000000000000000**
**000000000000000000000000000000000000000**
**0000XXX000000000000XXX00000000XXX000000**
**000000000000000000000000000000000000000**
**00000000000000XXX0000000000000000000000**
**000000000000000000000000000000000000000**
**00000000XXX0000000000000000000000000000**
**000000000000000000000000000000000000000**
**000000000000000000000000000000000000000**
*****~*************************************