**000000000000000000000000000000000000000000000**
**XX000000000000000000000000000000000XOX0000000**
**000000000000000000000000000000000000000000000**
**000000000000000000000000000000000000000000000**
**00000000000000000000000XXX0000000000000000000**
**000000000000000000000000000000000000XXX000000**
**000000XXX000000000000000000000000000000000000**
**000000000000000000000000000000000000000000000**
**000000000000000000000000000000000000000000000**
**0000000000000000000000XXXX0000000000000000000**
**000000000000000000000000000000000000000000000**
**000000000X00000000000000000000000000000000000**
**000000000000000000X000000000000000XXX00000000**
**000000000000000000000000000000000000000000000**
**00000000000000000000000XXXX000000000000000000**
**000XX0000000000000000000000000000000000000000**
**000000000000000000000000000000000000000000000**
**00000000000000X~XX000000000000000000000000000**
**000000000000000000000000000000000000000000000**
**000000000000000000000000000000000000000000000**
*************************************************
*************************************************