**000000000000000000000000000000000000000**
**000000000000000000000XXXXXXXXXXXXXXX000**
**000000000000000000000000000000000000000**
**000000000000000000000000000000000000000**
**000000000000000000000000000000000000000**
**000000000000000000000000000000000000000**
**000000000XXX000000000000000000000000000**
**000000000000000000000000000000000000000**
**000000000000000000000000000000000000000**
**000000000000000000000000000000000000000**
**000000000000000000000000000000000000000**
**000000000000000000000000000000000000000**
**0000000000000000000XXX00000000XXX000000**
**000000000000000000000000000000000000000**
**000000000000000000000000000000000000000**
**000000000000000000000000000000000000000**
**000000000000000000000000000000000000000**
**000000000000000000000000000000000000000**
**000000000000000000000000000000000000000**
*******************************************
*******************************************